15 12
3  3  1  2  5  6 6  8 6  6  3 3 5  3 3
3  4  9  1  4  2 6  6 6  3  3 2 1  9 4
3  3  2  1 10  1 8  6 3  4 10 3 1  2 3
2  1  1  3  1  3 6  8 3  1  1 2 1  1 2
1 10  5  1  2  3 3 10 1  5  3 1 1 10 1
6  3  3  4  1 10 1  4 1 10  1 5 3  3 6
6  6  3  2  3  3 2  1 3  3  2 3 3  6 6
8  6  6  6  3  1 3  5 2  3  6 6 6  6 8
6  6  8  6  5 10 2  1 1  1  6 6 6  8 6
6  6  6  6  3  4 1  2 1  5  3 6 6  6 6
6  8  6  6  6  3 1  9 1  4  2 6 8  6 6  
6  6  8  6  6  3 3  2 4  3  3 6 6  8 6